Code de la commune,Libellé de la commune,Inscrits,Abstentions,Votants,NomPrénom,Année
75056,Paris,1368025,296668,1071357,MACRON Emmanuel,22
77001,Achères-la-Forêt,920,158,762,MACRON Emmanuel,22
77002,Amillis,560,121,439,LE PEN Marine,22
77003,Amponville,295,59,236,MACRON Emmanuel,22
77004,Andrezel,209,25,184,LE PEN Marine,22
77005,Annet-sur-Marne,2188,406,1782,MACRON Emmanuel,22
77006,Arbonne-la-Forêt,714,133,581,MACRON Emmanuel,22
77007,Argentières,278,45,233,LE PEN Marine,22
77008,Armentières-en-Brie,796,282,514,LE PEN Marine,22
77009,Arville,107,22,85,LE PEN Marine,22
77010,Aubepierre-Ozouer-le-Repos,679,113,566,LE PEN Marine,22
77011,Aufferville,407,107,300,LE PEN Marine,22
77012,Augers-en-Brie,222,55,167,LE PEN Marine,22
77013,Aulnoy,306,73,233,MACRON Emmanuel,22
77014,Avon,8569,2177,6392,MACRON Emmanuel,22
77015,Baby,71,16,55,LE PEN Marine,22
77016,Bagneaux-sur-Loing,990,268,722,LE PEN Marine,22
77018,Bailly-Romainvilliers,4356,903,3453,MACRON Emmanuel,22
77019,Balloy,257,54,203,LE PEN Marine,22
77020,Bannost-Villegagnon,428,89,339,LE PEN Marine,22
77021,Barbey,139,20,119,LE PEN Marine,22
77022,Barbizon,1254,243,1011,MACRON Emmanuel,22
77023,Barcy,240,56,184,LE PEN Marine,22
77024,Bassevelle,250,42,208,LE PEN Marine,22
77025,Bazoches-lès-Bray,678,142,536,LE PEN Marine,22
77026,Beauchery-Saint-Martin,293,61,232,LE PEN Marine,22
77027,Beaumont-du-Gâtinais,756,211,545,LE PEN Marine,22
77029,Beauvoir,142,15,127,LE PEN Marine,22
77030,Bellot,577,125,452,LE PEN Marine,22
77031,Bernay-Vilbert,677,147,530,LE PEN Marine,22
77032,Beton-Bazoches,542,140,402,LE PEN Marine,22
77033,Bezalles,169,40,129,LE PEN Marine,22
77034,Blandy,593,100,493,LE PEN Marine,22
77035,Blennes,421,82,339,LE PEN Marine,22
77036,Boisdon,81,9,72,MACRON Emmanuel,22
77037,Bois-le-Roi,4999,967,4032,MACRON Emmanuel,22
77038,Boissettes,315,63,252,MACRON Emmanuel,22
77039,Boissise-la-Bertrand,766,126,640,MACRON Emmanuel,22
77040,Boissise-le-Roi,2714,490,2224,MACRON Emmanuel,22
77041,Boissy-aux-Cailles,241,55,186,MACRON Emmanuel,22
77042,Boissy-le-Châtel,2521,609,1912,LE PEN Marine,22
77043,Boitron,240,55,185,LE PEN Marine,22
77044,Bombon,676,151,525,LE PEN Marine,22
77045,Bougligny,548,141,407,LE PEN Marine,22
77046,Boulancourt,273,53,220,LE PEN Marine,22
77047,Bouleurs,1142,263,879,LE PEN Marine,22
77048,Bourron-Marlotte,2326,467,1859,MACRON Emmanuel,22
77049,Boutigny,727,141,586,MACRON Emmanuel,22
77050,Bransles,430,96,334,MACRON Emmanuel,22
77051,Bray-sur-Seine,1467,430,1037,LE PEN Marine,22
77052,Bréau,269,69,200,LE PEN Marine,22
77053,Brie-Comte-Robert,11006,2953,8053,MACRON Emmanuel,22
77054,La Brosse-Montceaux,572,126,446,LE PEN Marine,22
77055,Brou-sur-Chantereine,2703,691,2012,MÉLENCHON Jean-Luc,22
77056,Burcy,131,32,99,LE PEN Marine,22
77057,Bussières,315,75,240,MACRON Emmanuel,22
77058,Bussy-Saint-Georges,16175,3988,12187,MACRON Emmanuel,22
77059,Bussy-Saint-Martin,539,78,461,MACRON Emmanuel,22
77060,Buthiers,532,95,437,MACRON Emmanuel,22
77061,Cannes-Ecluse,1635,342,1293,LE PEN Marine,22
77062,Carnetin,328,53,275,MACRON Emmanuel,22
77063,La Celle-sur-Morin,899,176,723,LE PEN Marine,22
77065,Cély,922,172,750,MACRON Emmanuel,22
77066,Cerneux,201,39,162,LE PEN Marine,22
77067,Cesson,7569,1641,5928,MACRON Emmanuel,22
77068,Cessoy-en-Montois,176,34,142,LE PEN Marine,22
77069,Chailly-en-Bière,1487,306,1181,MACRON Emmanuel,22
77070,Chailly-en-Brie,966,219,747,LE PEN Marine,22
77071,Chaintreaux,731,171,560,LE PEN Marine,22
77072,Chalautre-la-Grande,461,115,346,LE PEN Marine,22
77073,Chalautre-la-Petite,421,74,347,LE PEN Marine,22
77075,Chalifert,1059,241,818,MACRON Emmanuel,22
77076,Chalmaison,568,133,435,LE PEN Marine,22
77077,Chambry,731,164,567,LE PEN Marine,22
77078,Chamigny,874,200,674,LE PEN Marine,22
77079,Champagne-sur-Seine,3756,1095,2661,LE PEN Marine,22
77080,Champcenest,154,28,126,LE PEN Marine,22
77081,Champdeuil,431,59,372,LE PEN Marine,22
77082,Champeaux,576,76,500,LE PEN Marine,22
77083,Champs-sur-Marne,14397,3582,10815,MÉLENCHON Jean-Luc,22
77084,Changis-sur-Marne,994,236,758,LE PEN Marine,22
77085,Chanteloup-en-Brie,2459,526,1933,MACRON Emmanuel,22
77086,La Chapelle-Gauthier,976,261,715,LE PEN Marine,22
77087,La Chapelle-Iger,128,24,104,LE PEN Marine,22
77088,La Chapelle-la-Reine,1623,383,1240,LE PEN Marine,22
77089,La Chapelle-Rablais,657,111,546,LE PEN Marine,22
77090,La Chapelle-Saint-Sulpice,154,10,144,LE PEN Marine,22
77091,Les Chapelles-Bourbon,368,68,300,LE PEN Marine,22
77093,La Chapelle-Moutils,254,39,215,LE PEN Marine,22
77094,Charmentray,187,36,151,LE PEN Marine,22
77095,Charny,972,190,782,LE PEN Marine,22
77096,Chartrettes,2048,360,1688,MACRON Emmanuel,22
77097,Chartronges,237,60,177,LE PEN Marine,22
77098,Châteaubleau,281,57,224,LE PEN Marine,22
77099,Château-Landon,2111,588,1523,LE PEN Marine,22
77100,Le Châtelet-en-Brie,3341,800,2541,LE PEN Marine,22
77101,Châtenay-sur-Seine,743,206,537,LE PEN Marine,22
77102,Châtenoy,118,18,100,MÉLENCHON Jean-Luc,22
77103,Châtillon-la-Borde,186,30,156,LE PEN Marine,22
77104,Châtres,519,90,429,LE PEN Marine,22
77106,Chauffry,736,159,577,LE PEN Marine,22
77107,Chaumes-en-Brie,2189,520,1669,LE PEN Marine,22
77108,Chelles,33025,9181,23844,MÉLENCHON Jean-Luc,22
77109,Chenoise-Cucharmoy,1079,250,829,LE PEN Marine,22
77110,Chenou,238,34,204,LE PEN Marine,22
77111,Chessy,3918,742,3176,MACRON Emmanuel,22
77112,Chevrainvilliers,195,27,168,LE PEN Marine,22
77113,Chevru,729,141,588,LE PEN Marine,22
77114,Chevry-Cossigny,2887,637,2250,MACRON Emmanuel,22
77115,Chevry-en-Sereine,381,65,316,LE PEN Marine,22
77116,Choisy-en-Brie,942,201,741,LE PEN Marine,22
77117,Citry,574,128,446,LE PEN Marine,22
77118,Claye-Souilly,8034,1611,6423,MACRON Emmanuel,22
77119,Clos-Fontaine,162,31,131,LE PEN Marine,22
77120,Cocherel,422,90,332,LE PEN Marine,22
77121,Collégien,2346,473,1873,MACRON Emmanuel,22
77122,Combs-la-Ville,14387,3888,10499,MÉLENCHON Jean-Luc,22
77123,Compans,502,110,392,LE PEN Marine,22
77124,Conches-sur-Gondoire,1240,215,1025,MACRON Emmanuel,22
77125,Condé-Sainte-Libiaire,1072,222,850,MACRON Emmanuel,22
77126,Congis-sur-Thérouanne,1225,298,927,LE PEN Marine,22
77127,Coubert,1026,198,828,LE PEN Marine,22
77128,Couilly-Pont-aux-Dames,1444,329,1115,LE PEN Marine,22
77129,Coulombs-en-Valois,407,101,306,LE PEN Marine,22
77130,Coulommes,336,55,281,LE PEN Marine,22
77131,Coulommiers,9229,2954,6275,LE PEN Marine,22
77132,Coupvray,2266,395,1871,MACRON Emmanuel,22
77133,Courcelles-en-Bassée,160,25,135,LE PEN Marine,22
77134,Courchamp,105,14,91,LE PEN Marine,22
77135,Courpalay,1059,286,773,LE PEN Marine,22
77136,Courquetaine,167,37,130,LE PEN Marine,22
77137,Courtacon,165,40,125,LE PEN Marine,22
77138,Courtomer,422,85,337,LE PEN Marine,22
77139,Courtry,4619,1118,3501,LE PEN Marine,22
77140,Coutençon,187,24,163,LE PEN Marine,22
77141,Coutevroult,726,146,580,LE PEN Marine,22
77142,Crécy-la-Chapelle,3354,815,2539,LE PEN Marine,22
77143,Crégy-lès-Meaux,3406,793,2613,MÉLENCHON Jean-Luc,22
77144,Crèvecoeur-en-Brie,309,61,248,LE PEN Marine,22
77145,Crisenoy,483,100,383,LE PEN Marine,22
77146,Croissy-Beaubourg,1633,302,1331,MACRON Emmanuel,22
77147,La Croix-en-Brie,531,126,405,LE PEN Marine,22
77148,Crouy-sur-Ourcq,1251,303,948,LE PEN Marine,22
77150,Cuisy,320,68,252,LE PEN Marine,22
77151,Dagny,223,38,185,LE PEN Marine,22
77152,Dammarie-les-Lys,12029,3943,8086,MÉLENCHON Jean-Luc,22
77153,Dammartin-en-Goële,6361,1411,4950,MÉLENCHON Jean-Luc,22
77154,Dammartin-sur-Tigeaux,728,115,613,MACRON Emmanuel,22
77155,Dampmart,2346,548,1798,MACRON Emmanuel,22
77156,Darvault,613,143,470,LE PEN Marine,22
77157,Dhuisy,234,60,174,LE PEN Marine,22
77158,Diant,173,26,147,LE PEN Marine,22
77159,Donnemarie-Dontilly,1962,479,1483,LE PEN Marine,22
77161,Dormelles,607,127,480,LE PEN Marine,22
77162,Doue,740,157,583,LE PEN Marine,22
77163,Douy-la-Ramée,220,33,187,LE PEN Marine,22
77164,Echouboulains,402,70,332,LE PEN Marine,22
77165,Les Ecrennes,475,108,367,LE PEN Marine,22
77167,Egligny,206,48,158,LE PEN Marine,22
77168,Egreville,1621,367,1254,LE PEN Marine,22
77169,Emerainville,4754,1112,3642,MÉLENCHON Jean-Luc,22
77171,Esbly,4185,895,3290,MACRON Emmanuel,22
77172,Esmans,681,142,539,LE PEN Marine,22
77173,Etrépilly,589,165,424,LE PEN Marine,22
77174,Everly,468,132,336,LE PEN Marine,22
77175,Evry-Grégy-sur-Yerre,2180,448,1732,MACRON Emmanuel,22
77176,Faremoutiers,2014,490,1524,LE PEN Marine,22
77177,Favières,845,176,669,MACRON Emmanuel,22
77178,Faÿ-lès-Nemours,370,69,301,MACRON Emmanuel,22
77179,Féricy,531,82,449,MACRON Emmanuel,22
77180,Férolles-Attilly,905,189,716,MACRON Emmanuel,22
77181,Ferrières-en-Brie,2098,346,1752,MACRON Emmanuel,22
77182,La Ferté-Gaucher,2429,680,1749,LE PEN Marine,22
77183,La Ferté-sous-Jouarre,5820,1823,3997,LE PEN Marine,22
77184,Flagy,513,104,409,LE PEN Marine,22
77185,Fleury-en-Bière,494,94,400,MACRON Emmanuel,22
77186,Fontainebleau,9545,1960,7585,MACRON Emmanuel,22
77187,Fontaine-Fourches,422,106,316,LE PEN Marine,22
77188,Fontaine-le-Port,777,161,616,MACRON Emmanuel,22
77190,Fontains,209,37,172,LE PEN Marine,22
77191,Fontenailles,843,169,674,LE PEN Marine,22
77192,Fontenay-Trésigny,3776,961,2815,LE PEN Marine,22
77193,Forfry,156,18,138,LE PEN Marine,22
77194,Forges,256,41,215,LE PEN Marine,22
77195,Fouju,458,85,373,LE PEN Marine,22
77196,Fresnes-sur-Marne,564,108,456,LE PEN Marine,22
77197,Frétoy,114,16,98,LE PEN Marine,22
77198,Fromont,162,34,128,MACRON Emmanuel,22
77199,Fublaines,921,225,696,LE PEN Marine,22
77200,Garentreville,91,15,76,LE PEN Marine,22
77201,Gastins,516,97,419,LE PEN Marine,22
77202,La Genevraye,590,136,454,LE PEN Marine,22
77203,Germigny-l'Evêque,1059,189,870,LE PEN Marine,22
77204,Germigny-sous-Coulombs,157,25,132,LE PEN Marine,22
77205,Gesvres-le-Chapitre,119,15,104,LE PEN Marine,22
77206,Giremoutiers,131,26,105,LE PEN Marine,22
77207,Gironville,118,20,98,LE PEN Marine,22
77208,Gouaix,1045,305,740,LE PEN Marine,22
77209,Gouvernes,927,155,772,MACRON Emmanuel,22
77210,La Grande-Paroisse,1951,467,1484,LE PEN Marine,22
77211,Grandpuits-Bailly-Carrois,641,117,524,LE PEN Marine,22
77212,Gravon,148,36,112,LE PEN Marine,22
77214,Gressy,687,119,568,MACRON Emmanuel,22
77215,Gretz-Armainvilliers,5062,1372,3690,MÉLENCHON Jean-Luc,22
77216,Grez-sur-Loing,973,207,766,MACRON Emmanuel,22
77217,Grisy-Suisnes,1949,461,1488,LE PEN Marine,22
77218,Grisy-sur-Seine,93,29,64,MACRON Emmanuel,22
77219,Guérard,1730,292,1438,LE PEN Marine,22
77220,Guercheville,211,35,176,LE PEN Marine,22
77221,Guermantes,881,152,729,MACRON Emmanuel,22
77222,Guignes,2601,671,1930,LE PEN Marine,22
77223,Gurcy-le-Châtel,417,103,314,LE PEN Marine,22
77224,Hautefeuille,128,20,108,MACRON Emmanuel,22
77225,La Haute-Maison,220,50,170,MACRON Emmanuel,22
77226,Héricy,2050,380,1670,MACRON Emmanuel,22
77227,Hermé,451,92,359,LE PEN Marine,22
77228,Hondevilliers,213,52,161,LE PEN Marine,22
77229,La Houssaye-en-Brie,1313,278,1035,LE PEN Marine,22
77230,Ichy,125,27,98,LE PEN Marine,22
77231,Isles-les-Meldeuses,522,124,398,LE PEN Marine,22
77232,Isles-lès-Villenoy,710,156,554,LE PEN Marine,22
77233,Iverny,362,63,299,LE PEN Marine,22
77234,Jablines,519,108,411,MACRON Emmanuel,22
77235,Jaignes,255,58,197,LE PEN Marine,22
77236,Jaulnes,281,60,221,LE PEN Marine,22
77237,Jossigny,471,99,372,MACRON Emmanuel,22
77238,Jouarre,2780,816,1964,LE PEN Marine,22
77239,Jouy-le-Châtel,977,196,781,LE PEN Marine,22
77240,Jouy-sur-Morin,1531,463,1068,LE PEN Marine,22
77241,Juilly,1432,324,1108,LE PEN Marine,22
77242,Jutigny,324,65,259,LE PEN Marine,22
77243,Lagny-sur-Marne,13217,3057,10160,MACRON Emmanuel,22
77244,Larchant,647,136,511,MACRON Emmanuel,22
77245,Laval-en-Brie,356,95,261,LE PEN Marine,22
77246,Léchelle,402,68,334,LE PEN Marine,22
77247,Lescherolles,367,86,281,LE PEN Marine,22
77248,Lesches,542,116,426,MACRON Emmanuel,22
77249,Lésigny,5576,1328,4248,MACRON Emmanuel,22
77250,Leudon-en-Brie,114,17,97,LE PEN Marine,22
77251,Lieusaint,7080,1820,5260,MÉLENCHON Jean-Luc,22
77252,Limoges-Fourches,400,88,312,LE PEN Marine,22
77253,Lissy,224,36,188,LE PEN Marine,22
77254,Liverdy-en-Brie,1024,210,814,LE PEN Marine,22
77255,Livry-sur-Seine,1685,361,1324,MACRON Emmanuel,22
77256,Lizines,117,14,103,LE PEN Marine,22
77257,Lizy-sur-Ourcq,1886,530,1356,LE PEN Marine,22
77258,Lognes,8641,2307,6334,MÉLENCHON Jean-Luc,22
77259,Longperrier,1531,375,1156,LE PEN Marine,22
77260,Longueville,1060,284,776,LE PEN Marine,22
77261,Lorrez-le-Bocage-Préaux,934,222,712,LE PEN Marine,22
77262,Louan-Villegruis-Fontaine,361,83,278,LE PEN Marine,22
77263,Luisetaines,185,43,142,LE PEN Marine,22
77264,Lumigny-Nesles-Ormeaux,1079,221,858,LE PEN Marine,22
77265,Luzancy,787,199,588,LE PEN Marine,22
77266,Machault,539,104,435,MACRON Emmanuel,22
77267,La Madeleine-sur-Loing,264,66,198,MACRON Emmanuel,22
77268,Magny-le-Hongre,5254,1074,4180,MACRON Emmanuel,22
77269,Maincy,1325,314,1011,MACRON Emmanuel,22
77270,Maisoncelles-en-Brie,710,152,558,LE PEN Marine,22
77271,Maisoncelles-en-Gâtinais,102,19,83,LE PEN Marine,22
77272,Maison-Rouge,631,145,486,LE PEN Marine,22
77273,Marchémoret,406,84,322,LE PEN Marine,22
77274,Marcilly,288,48,240,LE PEN Marine,22
77275,Les Marêts,113,33,80,LE PEN Marine,22
77276,Mareuil-lès-Meaux,1763,359,1404,LE PEN Marine,22
77277,Marles-en-Brie,1297,266,1031,MACRON Emmanuel,22
77278,Marolles-en-Brie,320,65,255,LE PEN Marine,22
77279,Marolles-sur-Seine,1218,253,965,LE PEN Marine,22
77280,Mary-sur-Marne,832,210,622,LE PEN Marine,22
77281,Mauperthuis,384,91,293,LE PEN Marine,22
77282,Mauregard,238,37,201,LE PEN Marine,22
77283,May-en-Multien,556,121,435,LE PEN Marine,22
77284,Meaux,28600,8883,19717,MÉLENCHON Jean-Luc,22
77285,Le Mée-sur-Seine,10460,3200,7260,MÉLENCHON Jean-Luc,22
77286,Meigneux,187,16,171,MACRON Emmanuel,22
77287,Meilleray,376,128,248,LE PEN Marine,22
77288,Melun,18870,6438,12432,MÉLENCHON Jean-Luc,22
77289,Melz-sur-Seine,267,55,212,LE PEN Marine,22
77290,Méry-sur-Marne,461,120,341,LE PEN Marine,22
77291,Le Mesnil-Amelot,555,156,399,LE PEN Marine,22
77292,Messy,705,118,587,LE PEN Marine,22
77293,Misy-sur-Yonne,726,187,539,LE PEN Marine,22
77294,Mitry-Mory,11623,3013,8610,MÉLENCHON Jean-Luc,22
77295,Moisenay,1049,210,839,LE PEN Marine,22
77296,Moissy-Cramayel,10002,2452,7550,MÉLENCHON Jean-Luc,22
77297,Mondreville,288,69,219,LE PEN Marine,22
77298,Mons-en-Montois,351,71,280,LE PEN Marine,22
77300,Montceaux-lès-Meaux,423,57,366,LE PEN Marine,22
77301,Montceaux-lès-Provins,245,58,187,LE PEN Marine,22
77302,Montcourt-Fromonville,1428,235,1193,LE PEN Marine,22
77303,Montdauphin,190,45,145,LE PEN Marine,22
77304,Montenils,36,8,28,LE PEN Marine,22
77305,Montereau-Fault-Yonne,9875,3563,6312,MÉLENCHON Jean-Luc,22
77306,Montereau-sur-le-Jard,448,104,344,LE PEN Marine,22
77307,Montévrain,7514,1645,5869,MACRON Emmanuel,22
77308,Montgé-en-Goële,494,113,381,LE PEN Marine,22
77309,Monthyon,1145,208,937,LE PEN Marine,22
77310,Montigny-le-Guesdier,219,40,179,LE PEN Marine,22
77311,Montigny-Lencoup,977,203,774,LE PEN Marine,22
77312,Montigny-sur-Loing,2230,515,1715,MACRON Emmanuel,22
77313,Montmachoux,186,27,159,LE PEN Marine,22
77314,Montolivet,194,23,171,LE PEN Marine,22
77315,Montry,2576,608,1968,MACRON Emmanuel,22
77316,Moret-Loing-et-Orvanne,9600,2229,7371,MACRON Emmanuel,22
77317,Mormant,3181,861,2320,LE PEN Marine,22
77318,Mortcerf,1006,181,825,LE PEN Marine,22
77319,Mortery,105,27,78,MACRON Emmanuel,22
77320,Mouroux,4011,1047,2964,LE PEN Marine,22
77321,Mousseaux-lès-Bray,530,139,391,LE PEN Marine,22
77322,Moussy-le-Neuf,2247,511,1736,LE PEN Marine,22
77323,Moussy-le-Vieux,855,166,689,LE PEN Marine,22
77325,Mouy-sur-Seine,288,78,210,LE PEN Marine,22
77326,Nandy,4318,1103,3215,MÉLENCHON Jean-Luc,22
77327,Nangis,5200,1626,3574,LE PEN Marine,22
77328,Nanteau-sur-Essonne,367,52,315,MACRON Emmanuel,22
77329,Nanteau-sur-Lunain,395,82,313,LE PEN Marine,22
77330,Nanteuil-lès-Meaux,4337,1085,3252,MACRON Emmanuel,22
77331,Nanteuil-sur-Marne,313,82,231,LE PEN Marine,22
77332,Nantouillet,171,30,141,LE PEN Marine,22
77333,Nemours,6926,2118,4808,MÉLENCHON Jean-Luc,22
77335,Chauconin-Neufmontiers,1629,287,1342,LE PEN Marine,22
77336,Neufmoutiers-en-Brie,777,144,633,LE PEN Marine,22
77337,Noisiel,8810,2473,6337,MÉLENCHON Jean-Luc,22
77338,Noisy-Rudignon,402,82,320,LE PEN Marine,22
77339,Noisy-sur-Ecole,1553,331,1222,MACRON Emmanuel,22
77340,Nonville,478,100,378,LE PEN Marine,22
77341,Noyen-sur-Seine,271,49,222,LE PEN Marine,22
77342,Obsonville,85,13,72,LE PEN Marine,22
77343,Ocquerre,277,70,207,LE PEN Marine,22
77344,Oissery,1560,293,1267,LE PEN Marine,22
77345,Orly-sur-Morin,484,119,365,LE PEN Marine,22
77347,Les Ormes-sur-Voulzie,624,144,480,LE PEN Marine,22
77348,Ormesson,198,40,158,LE PEN Marine,22
77349,Othis,4664,1123,3541,LE PEN Marine,22
77350,Ozoir-la-Ferrière,14099,3668,10431,MACRON Emmanuel,22
77352,Ozouer-le-Voulgis,1351,306,1045,LE PEN Marine,22
77353,Paley,362,64,298,LE PEN Marine,22
77354,Pamfou,698,141,557,LE PEN Marine,22
77355,Paroy,135,20,115,MACRON Emmanuel,22
77356,Passy-sur-Seine,54,10,44,LE PEN Marine,22
77357,Pécy,622,148,474,LE PEN Marine,22
77358,Penchard,769,157,612,LE PEN Marine,22
77359,Perthes,1560,301,1259,MACRON Emmanuel,22
77360,Pézarches,308,48,260,LE PEN Marine,22
77361,Pierre-Levée,321,71,250,LE PEN Marine,22
77363,Le Pin,1029,252,777,LE PEN Marine,22
77364,Le Plessis-aux-Bois,171,44,127,LE PEN Marine,22
77365,Le Plessis-Feu-Aussoux,410,79,331,LE PEN Marine,22
77366,Le Plessis-l'Evêque,198,37,161,LE PEN Marine,22
77367,Le Plessis-Placy,191,47,144,LE PEN Marine,22
77368,Poigny,364,84,280,LE PEN Marine,22
77369,Poincy,531,82,449,LE PEN Marine,22
77370,Poligny,603,113,490,LE PEN Marine,22
77371,Pommeuse,2082,535,1547,LE PEN Marine,22
77372,Pomponne,2459,521,1938,MACRON Emmanuel,22
77373,Pontault-Combault,21992,5773,16219,MÉLENCHON Jean-Luc,22
77374,Pontcarré,1471,334,1137,MACRON Emmanuel,22
77376,Précy-sur-Marne,509,93,416,LE PEN Marine,22
77377,Presles-en-Brie,1588,336,1252,LE PEN Marine,22
77378,Pringy,2247,514,1733,MACRON Emmanuel,22
77379,Provins,6729,2060,4669,MÉLENCHON Jean-Luc,22
77380,Puisieux,242,48,194,LE PEN Marine,22
77381,Quiers,491,97,394,LE PEN Marine,22
77382,Quincy-Voisins,4012,977,3035,LE PEN Marine,22
77383,Rampillon,551,117,434,LE PEN Marine,22
77384,Réau,774,182,592,LE PEN Marine,22
77385,Rebais,1454,394,1060,LE PEN Marine,22
77386,Recloses,588,113,475,MACRON Emmanuel,22
77387,Remauville,341,80,261,LE PEN Marine,22
77388,Reuil-en-Brie,551,121,430,LE PEN Marine,22
77389,La Rochette,2201,425,1776,MACRON Emmanuel,22
77390,Roissy-en-Brie,13493,3333,10160,MÉLENCHON Jean-Luc,22
77391,Rouilly,347,93,254,LE PEN Marine,22
77392,Rouvres,625,118,507,LE PEN Marine,22
77393,Rozay-en-Brie,1876,476,1400,LE PEN Marine,22
77394,Rubelles,1659,316,1343,MACRON Emmanuel,22
77395,Rumont,90,15,75,MACRON Emmanuel,22
77396,Rupéreux,84,13,71,LE PEN Marine,22
77397,Saâcy-sur-Marne,1274,303,971,LE PEN Marine,22
77398,Sablonnières,501,134,367,LE PEN Marine,22
77400,Saint-Augustin,1383,305,1078,LE PEN Marine,22
77401,Sainte-Aulde,508,114,394,LE PEN Marine,22
77402,Saint-Barthélemy,259,53,206,LE PEN Marine,22
77403,Saint-Brice,552,123,429,LE PEN Marine,22
77404,Sainte-Colombe,1274,306,968,LE PEN Marine,22
77405,Saint-Cyr-sur-Morin,1426,297,1129,LE PEN Marine,22
77406,Saint-Denis-lès-Rebais,731,136,595,LE PEN Marine,22
77407,Saint-Fargeau-Ponthierry,9295,2401,6894,MACRON Emmanuel,22
77408,Saint-Fiacre,309,54,255,LE PEN Marine,22
77409,Saint-Germain-Laval,2080,538,1542,LE PEN Marine,22
77410,Saint-Germain-Laxis,540,116,424,LE PEN Marine,22
77411,Saint-Germain-sous-Doue,404,78,326,LE PEN Marine,22
77412,Saint-Germain-sur-Ecole,296,55,241,LE PEN Marine,22
77413,Saint-Germain-sur-Morin,2705,629,2076,LE PEN Marine,22
77414,Saint-Hilliers,378,96,282,LE PEN Marine,22
77415,Saint-Jean-les-Deux-Jumeaux,899,243,656,LE PEN Marine,22
77416,Saint-Just-en-Brie,196,41,155,LE PEN Marine,22
77417,Saint-Léger,159,33,126,LE PEN Marine,22
77418,Saint-Loup-de-Naud,619,150,469,LE PEN Marine,22
77419,Saint-Mammès,2353,597,1756,LE PEN Marine,22
77420,Saint-Mard,2766,747,2019,LE PEN Marine,22
77421,Saint-Mars-Vieux-Maisons,227,59,168,LE PEN Marine,22
77423,Saint-Martin-des-Champs,538,125,413,LE PEN Marine,22
77424,Saint-Martin-du-Boschet,209,52,157,LE PEN Marine,22
77425,Saint-Martin-en-Bière,634,125,509,MACRON Emmanuel,22
77426,Saint-Méry,264,36,228,MACRON Emmanuel,22
77427,Saint-Mesmes,431,70,361,LE PEN Marine,22
77428,Saint-Ouen-en-Brie,703,153,550,LE PEN Marine,22
77429,Saint-Ouen-sur-Morin,438,114,324,LE PEN Marine,22
77430,Saint-Pathus,4424,1009,3415,LE PEN Marine,22
77431,Saint-Pierre-lès-Nemours,4050,1040,3010,LE PEN Marine,22
77432,Saint-Rémy-la-Vanne,745,153,592,LE PEN Marine,22
77433,Beautheil-Saints,1645,443,1202,LE PEN Marine,22
77434,Saint-Sauveur-lès-Bray,292,57,235,LE PEN Marine,22
77435,Saint-Sauveur-sur-Ecole,891,157,734,MACRON Emmanuel,22
77436,Saint-Siméon,646,138,508,LE PEN Marine,22
77437,Saint-Soupplets,2235,467,1768,LE PEN Marine,22
77438,Saint-Thibault-des-Vignes,4522,1075,3447,MACRON Emmanuel,22
77439,Salins,807,206,601,LE PEN Marine,22
77440,Sammeron,749,181,568,LE PEN Marine,22
77441,Samois-sur-Seine,1680,307,1373,MACRON Emmanuel,22
77442,Samoreau,1958,419,1539,MACRON Emmanuel,22
77443,Sancy,287,58,229,LE PEN Marine,22
77444,Sancy-lès-Provins,258,52,206,LE PEN Marine,22
77445,Savigny-le-Temple,17771,5357,12414,MÉLENCHON Jean-Luc,22
77446,Savins,434,100,334,LE PEN Marine,22
77447,Seine-Port,1490,273,1217,MACRON Emmanuel,22
77448,Sept-Sorts,375,70,305,LE PEN Marine,22
77449,Serris,5041,1187,3854,MACRON Emmanuel,22
77450,Servon,2589,597,1992,MACRON Emmanuel,22
77451,Signy-Signets,406,79,327,LE PEN Marine,22
77452,Sigy,67,4,63,LE PEN Marine,22
77453,Sivry-Courtry,854,152,702,LE PEN Marine,22
77454,Sognolles-en-Montois,329,69,260,LE PEN Marine,22
77455,Soignolles-en-Brie,1460,331,1129,LE PEN Marine,22
77456,Soisy-Bouy,596,123,473,LE PEN Marine,22
77457,Solers,921,182,739,LE PEN Marine,22
77458,Souppes-sur-Loing,3458,1174,2284,LE PEN Marine,22
77459,Sourdun,988,211,777,LE PEN Marine,22
77460,Tancrou,261,61,200,LE PEN Marine,22
77461,Thénisy,238,41,197,LE PEN Marine,22
77462,Thieux,464,126,338,MÉLENCHON Jean-Luc,22
77463,Thomery,2813,565,2248,MACRON Emmanuel,22
77464,Thorigny-sur-Marne,6546,1646,4900,MACRON Emmanuel,22
77465,Thoury-Férottes,480,78,402,LE PEN Marine,22
77466,Tigeaux,285,47,238,LE PEN Marine,22
77467,La Tombe,196,45,151,LE PEN Marine,22
77468,Torcy,12626,3496,9130,MÉLENCHON Jean-Luc,22
77469,Touquin,920,209,711,LE PEN Marine,22
77470,Tournan-en-Brie,5619,1419,4200,MACRON Emmanuel,22
77471,Tousson,306,68,238,MÉLENCHON Jean-Luc,22
77472,La Trétoire,341,75,266,LE PEN Marine,22
77473,Treuzy-Levelay,355,66,289,LE PEN Marine,22
77474,Trilbardou,394,92,302,LE PEN Marine,22
77475,Trilport,3531,825,2706,LE PEN Marine,22
77476,Trocy-en-Multien,181,34,147,LE PEN Marine,22
77477,Ury,658,121,537,MACRON Emmanuel,22
77478,Ussy-sur-Marne,752,224,528,LE PEN Marine,22
77479,Vaires-sur-Marne,8705,2061,6644,MÉLENCHON Jean-Luc,22
77480,Valence-en-Brie,559,110,449,LE PEN Marine,22
77481,Vanvillé,140,25,115,LE PEN Marine,22
77482,Varennes-sur-Seine,2199,488,1711,MÉLENCHON Jean-Luc,22
77483,Varreddes,1271,235,1036,LE PEN Marine,22
77484,Vaucourtois,193,35,158,LE PEN Marine,22
77485,Le Vaudoué,674,114,560,MACRON Emmanuel,22
77486,Vaudoy-en-Brie,591,121,470,LE PEN Marine,22
77487,Vaux-le-Pénil,8405,1970,6435,MACRON Emmanuel,22
77489,Vaux-sur-Lunain,112,28,84,LE PEN Marine,22
77490,Vendrest,502,122,380,LE PEN Marine,22
77492,Verdelot,486,126,360,LE PEN Marine,22
77493,Verneuil-l'Etang,2181,521,1660,LE PEN Marine,22
77494,Vernou-la-Celle-sur-Seine,1916,425,1491,LE PEN Marine,22
77495,Vert-Saint-Denis,5542,1338,4204,MÉLENCHON Jean-Luc,22
77496,Vieux-Champagne,153,25,128,MÉLENCHON Jean-Luc,22
77498,Vignely,228,36,192,LE PEN Marine,22
77500,Villebéon,350,60,290,LE PEN Marine,22
77501,Villecerf,610,138,472,LE PEN Marine,22
77504,Villemaréchal,811,153,658,LE PEN Marine,22
77505,Villemareuil,277,67,210,LE PEN Marine,22
77506,Villemer,542,104,438,LE PEN Marine,22
77507,Villenauxe-la-Petite,331,65,266,LE PEN Marine,22
77508,Villeneuve-le-Comte,1319,272,1047,MACRON Emmanuel,22
77509,Villeneuve-les-Bordes,412,89,323,LE PEN Marine,22
77510,Villeneuve-Saint-Denis,616,105,511,MACRON Emmanuel,22
77511,Villeneuve-sous-Dammartin,328,44,284,LE PEN Marine,22
77512,Villeneuve-sur-Bellot,872,217,655,LE PEN Marine,22
77513,Villenoy,3011,804,2207,MÉLENCHON Jean-Luc,22
77514,Villeparisis,14098,3969,10129,MÉLENCHON Jean-Luc,22
77515,Villeroy,488,73,415,LE PEN Marine,22
77516,Ville-Saint-Jacques,545,92,453,MACRON Emmanuel,22
77517,Villevaudé,1439,352,1087,LE PEN Marine,22
77518,Villiers-en-Bière,174,35,139,MACRON Emmanuel,22
77519,Villiers-Saint-Georges,785,163,622,LE PEN Marine,22
77520,Villiers-sous-Grez,625,124,501,MACRON Emmanuel,22
77521,Villiers-sur-Morin,1329,249,1080,LE PEN Marine,22
77522,Villiers-sur-Seine,209,45,164,LE PEN Marine,22
77523,Villuis,202,53,149,LE PEN Marine,22
77524,Vimpelles,419,92,327,LE PEN Marine,22
77525,Vinantes,234,64,170,LE PEN Marine,22
77526,Vincy-Manoeuvre,196,55,141,LE PEN Marine,22
77527,Voinsles,430,71,359,MACRON Emmanuel,22
77528,Voisenon,905,185,720,MACRON Emmanuel,22
77529,Voulangis,1211,258,953,MACRON Emmanuel,22
77530,Voulton,245,42,203,LE PEN Marine,22
77531,Voulx,1248,307,941,LE PEN Marine,22
77532,Vulaines-lès-Provins,49,5,44,LE PEN Marine,22
77533,Vulaines-sur-Seine,2079,423,1656,MACRON Emmanuel,22
77534,Yèbles,566,99,467,LE PEN Marine,22
78003,Ablis,2508,518,1990,MACRON Emmanuel,22
78005,Achères,13194,3552,9642,MÉLENCHON Jean-Luc,22
78006,Adainville,628,112,516,MACRON Emmanuel,22
78007,Aigremont,862,181,681,MACRON Emmanuel,22
78009,Allainville,228,47,181,LE PEN Marine,22
78010,Les Alluets-le-Roi,1006,162,844,MACRON Emmanuel,22
78013,Andelu,403,73,330,MACRON Emmanuel,22
78015,Andrésy,9161,2059,7102,MACRON Emmanuel,22
78020,Arnouville-lès-Mantes,688,93,595,MACRON Emmanuel,22
78029,Aubergenville,6862,1713,5149,MÉLENCHON Jean-Luc,22
78030,Auffargis,1637,298,1339,MACRON Emmanuel,22
78031,Auffreville-Brasseuil,458,80,378,LE PEN Marine,22
78033,Aulnay-sur-Mauldre,873,154,719,MACRON Emmanuel,22
78034,Auteuil,711,112,599,MACRON Emmanuel,22
78036,Autouillet,480,69,411,MACRON Emmanuel,22
78043,Bailly,3126,607,2519,MACRON Emmanuel,22
78048,Bazainville,1131,188,943,MACRON Emmanuel,22
78049,Bazemont,1318,246,1072,MACRON Emmanuel,22
78050,Bazoches-sur-Guyonne,522,90,432,MACRON Emmanuel,22
78053,Béhoust,402,59,343,MACRON Emmanuel,22
78057,Bennecourt,1286,316,970,LE PEN Marine,22
78062,Beynes,5782,1223,4559,MACRON Emmanuel,22
78068,Blaru,728,163,565,LE PEN Marine,22
78070,Boinville-en-Mantois,233,36,197,MACRON Emmanuel,22
78071,Boinville-le-Gaillard,441,76,365,LE PEN Marine,22
78072,Boinvilliers,216,36,180,MACRON Emmanuel,22
78073,Bois-d'Arcy,9517,2106,7411,MACRON Emmanuel,22
78076,Boissets,223,35,188,MACRON Emmanuel,22
78077,La Boissière-Ecole,562,88,474,MACRON Emmanuel,22
78082,Boissy-Mauvoisin,439,80,359,LE PEN Marine,22
78084,Boissy-sans-Avoir,495,74,421,MACRON Emmanuel,22
78087,Bonnelles,1548,281,1267,MACRON Emmanuel,22
78089,Bonnières-sur-Seine,2744,796,1948,LE PEN Marine,22
78090,Bouafle,1380,293,1087,MACRON Emmanuel,22
78092,Bougival,5996,1314,4682,MACRON Emmanuel,22
78096,Bourdonné,459,76,383,MACRON Emmanuel,22
78104,Breuil-Bois-Robert,508,76,432,MACRON Emmanuel,22
78107,Bréval,1455,269,1186,LE PEN Marine,22
78108,Les Bréviaires,845,126,719,MACRON Emmanuel,22
78113,Brueil-en-Vexin,496,82,414,MACRON Emmanuel,22
78117,Buc,4353,706,3647,MACRON Emmanuel,22
78118,Buchelay,2047,467,1580,MÉLENCHON Jean-Luc,22
78120,Bullion,1416,227,1189,MACRON Emmanuel,22
78123,Carrières-sous-Poissy,9722,2741,6981,MÉLENCHON Jean-Luc,22
78124,Carrières-sur-Seine,9604,1847,7757,MACRON Emmanuel,22
78125,La Celle-les-Bordes,706,102,604,MACRON Emmanuel,22
78126,La Celle-Saint-Cloud,14194,3345,10849,MACRON Emmanuel,22
78128,Cernay-la-Ville,1112,133,979,MACRON Emmanuel,22
78133,Chambourcy,4077,879,3198,MACRON Emmanuel,22
78138,Chanteloup-les-Vignes,5688,1796,3892,MÉLENCHON Jean-Luc,22
78140,Chapet,930,155,775,MACRON Emmanuel,22
78143,Châteaufort,1277,227,1050,MACRON Emmanuel,22
78146,Chatou,20433,4263,16170,MACRON Emmanuel,22
78147,Chaufour-lès-Bonnières,329,49,280,LE PEN Marine,22
78152,Chavenay,1447,199,1248,MACRON Emmanuel,22
78158,Le Chesnay-Rocquencourt,22773,4439,18334,MACRON Emmanuel,22
78160,Chevreuse,4207,749,3458,MACRON Emmanuel,22
78162,Choisel,483,60,423,MACRON Emmanuel,22
78163,Civry-la-Forêt,283,48,235,MACRON Emmanuel,22
78164,Clairefontaine-en-Yvelines,625,88,537,MACRON Emmanuel,22
78165,Les Clayes-sous-Bois,11471,2804,8667,MACRON Emmanuel,22
78168,Coignières,2482,622,1860,MÉLENCHON Jean-Luc,22
78171,Condé-sur-Vesgre,941,190,751,MACRON Emmanuel,22
78172,Conflans-Sainte-Honorine,23993,6023,17970,MACRON Emmanuel,22
78185,Courgent,333,61,272,MACRON Emmanuel,22
78188,Cravent,338,58,280,MACRON Emmanuel,22
78189,Crespières,1431,276,1155,MACRON Emmanuel,22
78190,Croissy-sur-Seine,7556,1296,6260,MACRON Emmanuel,22
78192,Dammartin-en-Serve,1023,194,829,LE PEN Marine,22
78193,Dampierre-en-Yvelines,828,148,680,MACRON Emmanuel,22
78194,Dannemarie,169,11,158,MACRON Emmanuel,22
78196,Davron,252,41,211,MACRON Emmanuel,22
78202,Drocourt,343,32,311,LE PEN Marine,22
78206,Ecquevilly,2731,710,2021,MACRON Emmanuel,22
78208,Elancourt,16446,3584,12862,MACRON Emmanuel,22
78209,Emancé,665,106,559,MACRON Emmanuel,22
78217,Epône,4233,895,3338,MACRON Emmanuel,22
78220,Les Essarts-le-Roi,5003,1051,3952,MACRON Emmanuel,22
78224,L'Etang-la-Ville,3856,675,3181,MACRON Emmanuel,22
78227,Evecquemont,551,76,475,MACRON Emmanuel,22
78230,La Falaise,452,83,369,MACRON Emmanuel,22
78231,Favrieux,128,17,111,LE PEN Marine,22
78233,Feucherolles,2389,359,2030,MACRON Emmanuel,22
78234,Flacourt,129,22,107,LE PEN Marine,22
78236,Flexanville,492,95,397,MACRON Emmanuel,22
78237,Flins-Neuve-Eglise,118,21,97,MACRON Emmanuel,22
78238,Flins-sur-Seine,1670,383,1287,LE PEN Marine,22
78239,Follainville-Dennemont,1385,285,1100,LE PEN Marine,22
78242,Fontenay-le-Fleury,8190,1788,6402,MACRON Emmanuel,22
78245,Fontenay-Mauvoisin,398,55,343,MACRON Emmanuel,22
78246,Fontenay-Saint-Père,800,151,649,MACRON Emmanuel,22
78255,Freneuse,2944,768,2176,LE PEN Marine,22
78261,Gaillon-sur-Montcient,542,111,431,MACRON Emmanuel,22
78262,Galluis,992,204,788,MACRON Emmanuel,22
78263,Gambais,2109,421,1688,MACRON Emmanuel,22
78264,Gambaiseuil,63,6,57,MACRON Emmanuel,22
78265,Garancières,1954,395,1559,MACRON Emmanuel,22
78267,Gargenville,5280,1477,3803,LE PEN Marine,22
78269,Gazeran,995,179,816,MACRON Emmanuel,22
78276,Gommecourt,482,99,383,LE PEN Marine,22
78278,Goupillières,407,57,350,MACRON Emmanuel,22
78281,Goussonville,495,97,398,MACRON Emmanuel,22
78283,Grandchamp,231,36,195,MACRON Emmanuel,22
78285,Gressey,442,77,365,MACRON Emmanuel,22
78289,Grosrouvre,826,113,713,MACRON Emmanuel,22
78290,Guernes,743,132,611,LE PEN Marine,22
78291,Guerville,1593,380,1213,MACRON Emmanuel,22
78296,Guitrancourt,534,103,431,LE PEN Marine,22
78297,Guyancourt,18309,4408,13901,MÉLENCHON Jean-Luc,22
78299,Hardricourt,1559,355,1204,MACRON Emmanuel,22
78300,Hargeville,309,40,269,MACRON Emmanuel,22
78302,La Hauteville,192,43,149,MACRON Emmanuel,22
78305,Herbeville,211,26,185,MACRON Emmanuel,22
78307,Hermeray,872,156,716,MACRON Emmanuel,22
78310,Houdan,2307,447,1860,MACRON Emmanuel,22
78311,Houilles,21933,4776,17157,MACRON Emmanuel,22
78314,Issou,2963,605,2358,LE PEN Marine,22
78317,Jambville,588,106,482,MACRON Emmanuel,22
78320,Notre-Dame-de-la-Mer,565,132,433,LE PEN Marine,22
78321,Jouars-Pontchartrain,4294,784,3510,MACRON Emmanuel,22
78322,Jouy-en-Josas,4997,806,4191,MACRON Emmanuel,22
78324,Jouy-Mauvoisin,354,55,299,MACRON Emmanuel,22
78325,Jumeauville,483,102,381,MACRON Emmanuel,22
78327,Juziers,2766,651,2115,MACRON Emmanuel,22
78329,Lainville-en-Vexin,672,156,516,MACRON Emmanuel,22
78334,Lévis-Saint-Nom,1335,241,1094,MACRON Emmanuel,22
78335,Limay,9496,2668,6828,MÉLENCHON Jean-Luc,22
78337,Limetz-Villez,1562,387,1175,LE PEN Marine,22
78343,Les Loges-en-Josas,1303,248,1055,MACRON Emmanuel,22
78344,Lommoye,516,105,411,LE PEN Marine,22
78346,Longnes,1093,209,884,LE PEN Marine,22
78349,Longvilliers,392,63,329,MACRON Emmanuel,22
78350,Louveciennes,5204,890,4314,MACRON Emmanuel,22
78354,Magnanville,4167,985,3182,MÉLENCHON Jean-Luc,22
78356,Magny-les-Hameaux,6741,1482,5259,MACRON Emmanuel,22
78358,Maisons-Laffitte,17058,3317,13741,MACRON Emmanuel,22
78361,Mantes-la-Jolie,22184,7291,14893,MÉLENCHON Jean-Luc,22
78362,Mantes-la-Ville,11709,3774,7935,MÉLENCHON Jean-Luc,22
78364,Marcq,584,105,479,MACRON Emmanuel,22
78366,Mareil-le-Guyon,313,41,272,MACRON Emmanuel,22
78367,Mareil-Marly,2818,423,2395,MACRON Emmanuel,22
78368,Mareil-sur-Mauldre,1357,222,1135,MACRON Emmanuel,22
78372,Marly-le-Roi,12089,2390,9699,MACRON Emmanuel,22
78380,Maule,4235,815,3420,MACRON Emmanuel,22
78381,Maulette,720,103,617,MACRON Emmanuel,22
78382,Maurecourt,2932,545,2387,MACRON Emmanuel,22
78383,Maurepas,13508,3193,10315,MACRON Emmanuel,22
78384,Médan,1063,206,857,MACRON Emmanuel,22
78385,Ménerville,164,24,140,LE PEN Marine,22
78389,Méré,1425,231,1194,MACRON Emmanuel,22
78391,Méricourt,246,38,208,LE PEN Marine,22
78396,Le Mesnil-le-Roi,4710,980,3730,MACRON Emmanuel,22
78397,Le Mesnil-Saint-Denis,5346,1004,4342,MACRON Emmanuel,22
78398,Les Mesnuls,754,136,618,MACRON Emmanuel,22
78401,Meulan-en-Yvelines,4702,1268,3434,MÉLENCHON Jean-Luc,22
78402,Mézières-sur-Seine,2767,646,2121,MACRON Emmanuel,22
78403,Mézy-sur-Seine,1374,263,1111,MACRON Emmanuel,22
78404,Millemont,198,23,175,MACRON Emmanuel,22
78406,Milon-la-Chapelle,241,41,200,MACRON Emmanuel,22
78407,Mittainville,555,79,476,MACRON Emmanuel,22
78410,Moisson,719,177,542,MACRON Emmanuel,22
78413,Mondreville,292,45,247,LE PEN Marine,22
78415,Montainville,460,89,371,MACRON Emmanuel,22
78416,Montalet-le-Bois,239,39,200,LE PEN Marine,22
78417,Montchauvet,225,40,185,MACRON Emmanuel,22
78418,Montesson,10401,1947,8454,MACRON Emmanuel,22
78420,Montfort-l'Amaury,2117,547,1570,MACRON Emmanuel,22
78423,Montigny-le-Bretonneux,22987,4805,18182,MACRON Emmanuel,22
78431,Morainvilliers,2083,324,1759,MACRON Emmanuel,22
78437,Mousseaux-sur-Seine,575,132,443,LE PEN Marine,22
78439,Mulcent,94,18,76,MACRON Emmanuel,22
78440,Les Mureaux,16120,5512,10608,MÉLENCHON Jean-Luc,22
78442,Neauphle-le-Château,2318,397,1921,MACRON Emmanuel,22
78443,Neauphle-le-Vieux,661,86,575,MACRON Emmanuel,22
78444,Neauphlette,659,130,529,LE PEN Marine,22
78451,Nézel,724,139,585,LE PEN Marine,22
78455,Noisy-le-Roi,6095,1044,5051,MACRON Emmanuel,22
78460,Oinville-sur-Montcient,911,193,718,MACRON Emmanuel,22
78464,Orcemont,666,93,573,MACRON Emmanuel,22
78465,Orgerus,1995,406,1589,MACRON Emmanuel,22
78466,Orgeval,5055,975,4080,MACRON Emmanuel,22
78470,Orphin,702,117,585,MACRON Emmanuel,22
78472,Orsonville,236,33,203,LE PEN Marine,22
78474,Orvilliers,653,121,532,MACRON Emmanuel,22
78475,Osmoy,312,46,266,MACRON Emmanuel,22
78478,Paray-Douaville,141,15,126,LE PEN Marine,22
78481,Le Pecq,10663,2507,8156,MACRON Emmanuel,22
78484,Perdreauville,485,74,411,LE PEN Marine,22
78486,Le Perray-en-Yvelines,5178,1062,4116,MACRON Emmanuel,22
78490,Plaisir,19629,4667,14962,MACRON Emmanuel,22
78497,Poigny-la-Forêt,732,105,627,MACRON Emmanuel,22
78498,Poissy,22308,5190,17118,MACRON Emmanuel,22
78499,Ponthévrard,528,85,443,MACRON Emmanuel,22
78501,Porcheville,1889,472,1417,LE PEN Marine,22
78502,Le Port-Marly,3032,782,2250,MACRON Emmanuel,22
78505,Prunay-le-Temple,364,81,283,MACRON Emmanuel,22
78506,Prunay-en-Yvelines,644,125,519,MACRON Emmanuel,22
78513,La Queue-les-Yvelines,1724,321,1403,MACRON Emmanuel,22
78516,Raizeux,770,134,636,MACRON Emmanuel,22
78517,Rambouillet,19021,4023,14998,MACRON Emmanuel,22
78518,Rennemoulin,96,8,88,MACRON Emmanuel,22
78520,Richebourg,997,182,815,MACRON Emmanuel,22
78522,Rochefort-en-Yvelines,716,120,596,MACRON Emmanuel,22
78528,Rolleboise,213,41,172,MACRON Emmanuel,22
78530,Rosay,291,59,232,MACRON Emmanuel,22
78531,Rosny-sur-Seine,3996,937,3059,MÉLENCHON Jean-Luc,22
78536,Sailly,285,53,232,LE PEN Marine,22
78537,Saint-Arnoult-en-Yvelines,4590,887,3703,MACRON Emmanuel,22
78545,Saint-Cyr-l'Ecole,11946,2764,9182,MACRON Emmanuel,22
78548,Saint-Forget,383,52,331,MACRON Emmanuel,22
78550,Saint-Germain-de-la-Grange,1476,245,1231,MACRON Emmanuel,22
78551,Saint-Germain-en-Laye,28851,6208,22643,MACRON Emmanuel,22
78557,Saint-Hilarion,742,115,627,MACRON Emmanuel,22
78558,Saint-Illiers-la-Ville,283,67,216,LE PEN Marine,22
78559,Saint-Illiers-le-Bois,322,57,265,MACRON Emmanuel,22
78561,Saint-Lambert,359,39,320,MACRON Emmanuel,22
78562,Saint-Léger-en-Yvelines,1159,192,967,MACRON Emmanuel,22
78564,Saint-Martin-de-Bréthencourt,447,62,385,MACRON Emmanuel,22
78565,Saint-Martin-des-Champs,255,35,220,MACRON Emmanuel,22
78567,Saint-Martin-la-Garenne,722,119,603,LE PEN Marine,22
78569,Sainte-Mesme,637,114,523,MACRON Emmanuel,22
78571,Saint-Nom-la-Bretèche,3972,618,3354,MACRON Emmanuel,22
78575,Saint-Rémy-lès-Chevreuse,5930,1102,4828,MACRON Emmanuel,22
78576,Saint-Rémy-l'Honoré,1270,231,1039,MACRON Emmanuel,22
78586,Sartrouville,30877,8324,22553,MÉLENCHON Jean-Luc,22
78588,Saulx-Marchais,671,106,565,MACRON Emmanuel,22
78590,Senlisse,389,64,325,MACRON Emmanuel,22
78591,Septeuil,1591,373,1218,MACRON Emmanuel,22
78597,Soindres,509,103,406,MACRON Emmanuel,22
78601,Sonchamp,1260,221,1039,MACRON Emmanuel,22
78605,Tacoignières,843,128,715,MACRON Emmanuel,22
78606,Le Tartre-Gaudran,40,4,36,MACRON Emmanuel,22
78608,Le Tertre-Saint-Denis,99,15,84,LE PEN Marine,22
78609,Tessancourt-sur-Aubette,772,157,615,MACRON Emmanuel,22
78615,Thiverval-Grignon,696,120,576,MACRON Emmanuel,22
78616,Thoiry,1067,183,884,MACRON Emmanuel,22
78618,Tilly,423,72,351,MACRON Emmanuel,22
78620,Toussus-le-Noble,855,127,728,MACRON Emmanuel,22
78621,Trappes,14343,4052,10291,MÉLENCHON Jean-Luc,22
78623,Le Tremblay-sur-Mauldre,632,86,546,MACRON Emmanuel,22
78624,Triel-sur-Seine,8543,1928,6615,MACRON Emmanuel,22
78638,Vaux-sur-Seine,3274,739,2535,MACRON Emmanuel,22
78640,Vélizy-Villacoublay,14620,3098,11522,MACRON Emmanuel,22
78642,Verneuil-sur-Seine,10795,2609,8186,MACRON Emmanuel,22
78643,Vernouillet,6348,1483,4865,MACRON Emmanuel,22
78644,La Verrière,3090,951,2139,MÉLENCHON Jean-Luc,22
78646,Versailles,58169,11508,46661,MACRON Emmanuel,22
78647,Vert,585,108,477,MACRON Emmanuel,22
78650,Le Vésinet,12241,2189,10052,MACRON Emmanuel,22
78653,Vicq,240,22,218,MACRON Emmanuel,22
78655,Vieille-Eglise-en-Yvelines,570,92,478,MACRON Emmanuel,22
78668,La Villeneuve-en-Chevrie,488,92,396,LE PEN Marine,22
78672,Villennes-sur-Seine,4353,846,3507,MACRON Emmanuel,22
78674,Villepreux,7834,1501,6333,MACRON Emmanuel,22
78677,Villette,439,76,363,MACRON Emmanuel,22
78681,Villiers-le-Mahieu,620,90,530,MACRON Emmanuel,22
78683,Villiers-Saint-Fréderic,2364,396,1968,MACRON Emmanuel,22
78686,Viroflay,11648,1837,9811,MACRON Emmanuel,22
78688,Voisins-le-Bretonneux,8692,1273,7419,MACRON Emmanuel,22
91001,Abbéville-la-Rivière,232,44,188,LE PEN Marine,22
91016,Angerville,2859,756,2103,LE PEN Marine,22
91017,Angervilliers,1144,182,962,MACRON Emmanuel,22
91021,Arpajon,6108,1648,4460,MACRON Emmanuel,22
91022,Arrancourt,106,11,95,LE PEN Marine,22
91027,Athis-Mons,18626,4983,13643,MÉLENCHON Jean-Luc,22
91035,Authon-la-Plaine,252,59,193,LE PEN Marine,22
91037,Auvernaux,243,51,192,LE PEN Marine,22
91038,Auvers-Saint-Georges,887,195,692,MACRON Emmanuel,22
91041,Avrainville,708,108,600,MACRON Emmanuel,22
91044,Ballainvilliers,2817,477,2340,MACRON Emmanuel,22
91045,Ballancourt-sur-Essonne,4996,1012,3984,LE PEN Marine,22
91047,Baulne,933,210,723,LE PEN Marine,22
91064,Bièvres,3427,603,2824,MACRON Emmanuel,22
91067,Blandy,99,15,84,LE PEN Marine,22
91069,Boigneville,311,65,246,MACRON Emmanuel,22
91075,Bois-Herpin,69,7,62,LE PEN Marine,22
91079,Boissy-la-Rivière,420,66,354,LE PEN Marine,22
91080,Boissy-le-Cutté,823,237,586,LE PEN Marine,22
91081,Boissy-le-Sec,520,102,418,MACRON Emmanuel,22
91085,Boissy-sous-Saint-Yon,2899,600,2299,MACRON Emmanuel,22
91086,Bondoufle,7257,1554,5703,MACRON Emmanuel,22
91093,Boullay-les-Troux,507,94,413,MACRON Emmanuel,22
91095,Bouray-sur-Juine,1595,316,1279,MACRON Emmanuel,22
91097,Boussy-Saint-Antoine,4808,1263,3545,MÉLENCHON Jean-Luc,22
91098,Boutervilliers,307,58,249,LE PEN Marine,22
91099,Boutigny-sur-Essonne,2411,591,1820,LE PEN Marine,22
91100,Bouville,541,110,431,LE PEN Marine,22
91103,Brétigny-sur-Orge,15401,3723,11678,MÉLENCHON Jean-Luc,22
91105,Breuillet,5892,1338,4554,MACRON Emmanuel,22
91106,Breux-Jouy,948,202,746,MACRON Emmanuel,22
91109,Brières-les-Scellés,857,135,722,LE PEN Marine,22
91111,Briis-sous-Forges,2497,526,1971,MACRON Emmanuel,22
91112,Brouy,114,18,96,LE PEN Marine,22
91114,Brunoy,16718,3924,12794,MACRON Emmanuel,22
91115,Bruyères-le-Châtel,2275,362,1913,MACRON Emmanuel,22
91121,Buno-Bonnevaux,392,70,322,LE PEN Marine,22
91122,Bures-sur-Yvette,6885,1117,5768,MACRON Emmanuel,22
91129,Cerny,2507,588,1919,LE PEN Marine,22
91130,Chalo-Saint-Mars,862,140,722,MACRON Emmanuel,22
91131,Chalou-Moulineux,292,55,237,LE PEN Marine,22
91132,Chamarande,790,152,638,MACRON Emmanuel,22
91135,Champcueil,1854,396,1458,MACRON Emmanuel,22
91136,Champlan,1507,335,1172,MACRON Emmanuel,22
91137,Champmotteux,255,45,210,LE PEN Marine,22
91145,Chatignonville,60,11,49,MACRON Emmanuel,22
91148,Chauffour-lès-Etréchy,99,18,81,LE PEN Marine,22
91156,Cheptainville,1423,264,1159,MACRON Emmanuel,22
91159,Chevannes,1222,245,977,MACRON Emmanuel,22
91161,Chilly-Mazarin,10244,2489,7755,MÉLENCHON Jean-Luc,22
91174,Corbeil-Essonnes,22435,7624,14811,MÉLENCHON Jean-Luc,22
91175,Corbreuse,1193,219,974,MACRON Emmanuel,22
91179,Le Coudray-Montceaux,3142,661,2481,MACRON Emmanuel,22
91180,Courances,268,41,227,MACRON Emmanuel,22
91184,Courdimanche-sur-Essonne,217,37,180,LE PEN Marine,22
91186,Courson-Monteloup,460,99,361,MACRON Emmanuel,22
91191,Crosne,5848,1317,4531,MÉLENCHON Jean-Luc,22
91195,Dannemois,688,165,523,MACRON Emmanuel,22
91198,D'Huison-Longueville,1155,243,912,LE PEN Marine,22
91200,Dourdan,6804,1721,5083,MACRON Emmanuel,22
91201,Draveil,18392,4257,14135,MÉLENCHON Jean-Luc,22
91204,Echarcon,632,141,491,MACRON Emmanuel,22
91207,Egly,3657,926,2731,MÉLENCHON Jean-Luc,22
91215,Epinay-sous-Sénart,6198,1803,4395,MÉLENCHON Jean-Luc,22
91216,Epinay-sur-Orge,7056,1666,5390,MACRON Emmanuel,22
91223,Etampes,13247,3764,9483,MÉLENCHON Jean-Luc,22
91225,Etiolles,2511,555,1956,MACRON Emmanuel,22
91226,Etréchy,5048,1039,4009,MACRON Emmanuel,22
91228,Evry-Courcouronnes,33337,10792,22545,MÉLENCHON Jean-Luc,22
91232,La Ferté-Alais,2629,677,1952,LE PEN Marine,22
91235,Fleury-Mérogis,3749,1136,2613,MÉLENCHON Jean-Luc,22
91240,Fontaine-la-Rivière,134,25,109,MACRON Emmanuel,22
91243,Fontenay-lès-Briis,1569,316,1253,MACRON Emmanuel,22
91244,Fontenay-le-Vicomte,1049,189,860,LE PEN Marine,22
91247,La Forêt-le-Roi,424,99,325,MACRON Emmanuel,22
91248,La Forêt-Sainte-Croix,115,17,98,MACRON Emmanuel,22
91249,Forges-les-Bains,2930,525,2405,MACRON Emmanuel,22
91272,Gif-sur-Yvette,16006,2780,13226,MACRON Emmanuel,22
91273,Gironville-sur-Essonne,569,125,444,LE PEN Marine,22
91274,Gometz-la-Ville,1012,147,865,MACRON Emmanuel,22
91275,Gometz-le-Châtel,1721,287,1434,MACRON Emmanuel,22
91284,Les Granges-le-Roi,884,140,744,MACRON Emmanuel,22
91286,Grigny,10956,4162,6794,MÉLENCHON Jean-Luc,22
91292,Guibeville,633,103,530,LE PEN Marine,22
91293,Guigneville-sur-Essonne,713,135,578,LE PEN Marine,22
91294,Guillerval,572,105,467,LE PEN Marine,22
91312,Igny,7749,1590,6159,MACRON Emmanuel,22
91315,Itteville,4972,1133,3839,LE PEN Marine,22
91318,Janville-sur-Juine,1529,315,1214,MACRON Emmanuel,22
91319,Janvry,498,76,422,MACRON Emmanuel,22
91326,Juvisy-sur-Orge,9265,2297,6968,MÉLENCHON Jean-Luc,22
91330,Lardy,4384,876,3508,MACRON Emmanuel,22
91332,Leudeville,1059,154,905,LE PEN Marine,22
91333,Leuville-sur-Orge,2923,736,2187,MACRON Emmanuel,22
91338,Limours en Hurepoix,4907,962,3945,MACRON Emmanuel,22
91339,Linas,4535,1134,3401,LE PEN Marine,22
91340,Lisses,5418,1245,4173,MÉLENCHON Jean-Luc,22
91345,Longjumeau,12525,3401,9124,MÉLENCHON Jean-Luc,22
91347,Longpont-sur-Orge,4688,1103,3585,MACRON Emmanuel,22
91359,Maisse,1941,488,1453,LE PEN Marine,22
91363,Marcoussis,5985,1169,4816,MACRON Emmanuel,22
91374,Marolles-en-Beauce,159,27,132,LE PEN Marine,22
91376,Marolles-en-Hurepoix,4075,811,3264,MACRON Emmanuel,22
91377,Massy,29391,7252,22139,MÉLENCHON Jean-Luc,22
91378,Mauchamps,234,29,205,LE PEN Marine,22
91386,Mennecy,10753,2378,8375,MACRON Emmanuel,22
91390,Le Mérévillois,2618,690,1928,LE PEN Marine,22
91393,Mérobert,404,63,341,LE PEN Marine,22
91399,Mespuits,126,14,112,LE PEN Marine,22
91405,Milly-la-Forêt,3591,780,2811,MACRON Emmanuel,22
91408,Moigny-sur-Ecole,1070,199,871,MACRON Emmanuel,22
91411,Les Molières,1453,247,1206,MACRON Emmanuel,22
91412,Mondeville,571,130,441,LE PEN Marine,22
91414,Monnerville,255,64,191,LE PEN Marine,22
91421,Montgeron,15584,3929,11655,MACRON Emmanuel,22
91425,Montlhéry,5093,1090,4003,MACRON Emmanuel,22
91432,Morangis,8351,1854,6497,MACRON Emmanuel,22
91433,Morigny-Champigny,3445,787,2658,MACRON Emmanuel,22
91434,Morsang-sur-Orge,13660,3753,9907,MÉLENCHON Jean-Luc,22
91435,Morsang-sur-Seine,518,101,417,MACRON Emmanuel,22
91441,Nainville-les-Roches,370,69,301,LE PEN Marine,22
91457,La Norville,3275,675,2600,MACRON Emmanuel,22
91458,Nozay,3381,561,2820,MACRON Emmanuel,22
91461,Ollainville,3143,601,2542,LE PEN Marine,22
91463,Oncy-sur-Ecole,797,148,649,LE PEN Marine,22
91468,Ormoy,1398,293,1105,MÉLENCHON Jean-Luc,22
91469,Ormoy-la-Rivière,710,128,582,MACRON Emmanuel,22
91471,Orsay,11061,1975,9086,MACRON Emmanuel,22
91473,Orveau,165,37,128,LE PEN Marine,22
91477,Palaiseau,21969,4765,17204,MACRON Emmanuel,22
91479,Paray-Vieille-Poste,5035,1355,3680,LE PEN Marine,22
91482,Pecqueuse,391,66,325,MACRON Emmanuel,22
91494,Le Plessis-Pâté,2664,431,2233,MACRON Emmanuel,22
91495,Plessis-Saint-Benoist,243,43,200,MACRON Emmanuel,22
91507,Prunay-sur-Essonne,237,40,197,MACRON Emmanuel,22
91508,Puiselet-le-Marais,200,26,174,MACRON Emmanuel,22
91511,Pussay,1420,344,1076,LE PEN Marine,22
91514,Quincy-sous-Sénart,5528,1358,4170,MÉLENCHON Jean-Luc,22
91519,Richarville,311,51,260,MACRON Emmanuel,22
91521,Ris-Orangis,14592,4159,10433,MÉLENCHON Jean-Luc,22
91525,Roinville-sous-Dourdan,990,196,794,MACRON Emmanuel,22
91526,Roinvilliers,86,15,71,LE PEN Marine,22
91533,Saclas,1169,254,915,LE PEN Marine,22
91534,Saclay,2920,484,2436,MACRON Emmanuel,22
91538,Saint-Aubin,533,77,456,MACRON Emmanuel,22
91540,Saint-Chéron,3683,846,2837,MACRON Emmanuel,22
91544,Saint-Cyr-la-Rivière,384,72,312,LE PEN Marine,22
91546,Saint-Cyr-sous-Dourdan,835,148,687,MACRON Emmanuel,22
91547,Saint-Escobille,341,59,282,LE PEN Marine,22
91549,Sainte-Geneviève-des-Bois,20725,4969,15756,MÉLENCHON Jean-Luc,22
91552,Saint-Germain-lès-Arpajon,6043,1378,4665,MÉLENCHON Jean-Luc,22
91553,Saint-Germain-lès-Corbeil,5227,959,4268,MACRON Emmanuel,22
91556,Saint-Hilaire,285,34,251,MACRON Emmanuel,22
91560,Saint-Jean-de-Beauregard,278,39,239,MACRON Emmanuel,22
91568,Saint-Maurice-Montcouronne,1280,244,1036,MACRON Emmanuel,22
91570,Saint-Michel-sur-Orge,12412,3203,9209,MÉLENCHON Jean-Luc,22
91573,Saint-Pierre-du-Perray,7212,1714,5498,MÉLENCHON Jean-Luc,22
91577,Saintry-sur-Seine,4022,894,3128,MACRON Emmanuel,22
91578,Saint-Sulpice-de-Favières,272,45,227,MACRON Emmanuel,22
91579,Saint-Vrain,2133,435,1698,MACRON Emmanuel,22
91581,Saint-Yon,697,115,582,MACRON Emmanuel,22
91587,Saulx-les-Chartreux,4153,808,3345,MACRON Emmanuel,22
91589,Savigny-sur-Orge,21791,5185,16606,MACRON Emmanuel,22
91593,Sermaise,1290,279,1011,MACRON Emmanuel,22
91599,Soisy-sur-Ecole,919,204,715,MACRON Emmanuel,22
91600,Soisy-sur-Seine,5140,1024,4116,MACRON Emmanuel,22
91602,Souzy-la-Briche,246,40,206,MACRON Emmanuel,22
91613,Congerville-Thionville,160,26,134,LE PEN Marine,22
91617,Tigery,2506,520,1986,MACRON Emmanuel,22
91619,Torfou,221,40,181,MACRON Emmanuel,22
91629,Valpuiseaux,466,71,395,LE PEN Marine,22
91630,Le Val-Saint-Germain,1164,180,984,MACRON Emmanuel,22
91631,Varennes-Jarcy,1739,327,1412,MACRON Emmanuel,22
91634,Vaugrigneuse,934,152,782,MACRON Emmanuel,22
91635,Vauhallan,1583,271,1312,MACRON Emmanuel,22
91639,Vayres-sur-Essonne,658,125,533,LE PEN Marine,22
91645,Verrières-le-Buisson,11635,1942,9693,MACRON Emmanuel,22
91648,Vert-le-Grand,1737,379,1358,LE PEN Marine,22
91649,Vert-le-Petit,1979,453,1526,LE PEN Marine,22
91654,Videlles,514,105,409,LE PEN Marine,22
91657,Vigneux-sur-Seine,17520,5400,12120,MÉLENCHON Jean-Luc,22
91659,Villabé,3447,781,2666,MÉLENCHON Jean-Luc,22
91661,Villebon-sur-Yvette,7018,1422,5596,MACRON Emmanuel,22
91662,Villeconin,625,104,521,MACRON Emmanuel,22
91665,La Ville-du-Bois,5172,1153,4019,MACRON Emmanuel,22
91666,Villejust,1579,330,1249,MACRON Emmanuel,22
91667,Villemoisson-sur-Orge,5028,1000,4028,MACRON Emmanuel,22
91671,Villeneuve-sur-Auvers,464,106,358,MACRON Emmanuel,22
91679,Villiers-le-Bâcle,918,131,787,MACRON Emmanuel,22
91685,Villiers-sur-Orge,3108,625,2483,MACRON Emmanuel,22
91687,Viry-Chatillon,18300,5362,12938,MÉLENCHON Jean-Luc,22
91689,Wissous,5044,1139,3905,MACRON Emmanuel,22
91691,Yerres,20133,4799,15334,MACRON Emmanuel,22
91692,Les Ulis,13211,3927,9284,MÉLENCHON Jean-Luc,22
92002,Antony,41966,8309,33657,MACRON Emmanuel,22
92004,Asnières-sur-Seine,48963,9727,39236,MACRON Emmanuel,22
92007,Bagneux,22715,6656,16059,MÉLENCHON Jean-Luc,22
92009,Bois-Colombes,18207,3381,14826,MACRON Emmanuel,22
92012,Boulogne-Billancourt,72832,13702,59130,MACRON Emmanuel,22
92014,Bourg-la-Reine,13525,2427,11098,MACRON Emmanuel,22
92019,Châtenay-Malabry,19838,4561,15277,MACRON Emmanuel,22
92020,Châtillon,22251,4193,18058,MACRON Emmanuel,22
92022,Chaville,13646,2448,11198,MACRON Emmanuel,22
92023,Clamart,36492,7802,28690,MACRON Emmanuel,22
92024,Clichy,31899,7752,24147,MÉLENCHON Jean-Luc,22
92025,Colombes,48884,11355,37529,MÉLENCHON Jean-Luc,22
92026,Courbevoie,52492,11714,40778,MACRON Emmanuel,22
92032,Fontenay-aux-Roses,14764,3267,11497,MACRON Emmanuel,22
92033,Garches,12948,2606,10342,MACRON Emmanuel,22
92035,La Garenne-Colombes,19685,3978,15707,MACRON Emmanuel,22
92036,Gennevilliers,23623,6529,17094,MÉLENCHON Jean-Luc,22
92040,Issy-les-Moulineaux,45197,9299,35898,MACRON Emmanuel,22
92044,Levallois-Perret,43331,8484,34847,MACRON Emmanuel,22
92046,Malakoff,18340,3676,14664,MÉLENCHON Jean-Luc,22
92047,Marnes-la-Coquette,1253,180,1073,MACRON Emmanuel,22
92048,Meudon,30127,5862,24265,MACRON Emmanuel,22
92049,Montrouge,29101,5162,23939,MACRON Emmanuel,22
92050,Nanterre,50539,13460,37079,MÉLENCHON Jean-Luc,22
92051,Neuilly-sur-Seine,37469,6111,31358,MACRON Emmanuel,22
92060,Le Plessis-Robinson,19433,3805,15628,MACRON Emmanuel,22
92062,Puteaux,30003,5690,24313,MACRON Emmanuel,22
92063,Rueil-Malmaison,55143,11575,43568,MACRON Emmanuel,22
92064,Saint-Cloud,19486,3276,16210,MACRON Emmanuel,22
92071,Sceaux,14266,2941,11325,MACRON Emmanuel,22
92072,Sèvres,15108,2934,12174,MACRON Emmanuel,22
92073,Suresnes,29461,5864,23597,MACRON Emmanuel,22
92075,Vanves,18237,3341,14896,MACRON Emmanuel,22
92076,Vaucresson,6075,1061,5014,MACRON Emmanuel,22
92077,Ville-d'Avray,7570,1360,6210,MACRON Emmanuel,22
92078,Villeneuve-la-Garenne,12798,4302,8496,MÉLENCHON Jean-Luc,22
93001,Aubervilliers,30461,11130,19331,MÉLENCHON Jean-Luc,22
93005,Aulnay-sous-Bois,44373,13949,30424,MÉLENCHON Jean-Luc,22
93006,Bagnolet,19022,5700,13322,MÉLENCHON Jean-Luc,22
93007,Le Blanc-Mesnil,25982,8403,17579,MÉLENCHON Jean-Luc,22
93008,Bobigny,23366,8942,14424,MÉLENCHON Jean-Luc,22
93010,Bondy,25281,7549,17732,MÉLENCHON Jean-Luc,22
93013,Le Bourget,6257,1833,4424,MÉLENCHON Jean-Luc,22
93014,Clichy-sous-Bois,11832,4941,6891,MÉLENCHON Jean-Luc,22
93015,Coubron,3314,832,2482,MACRON Emmanuel,22
93027,La Courneuve,16090,5542,10548,MÉLENCHON Jean-Luc,22
93029,Drancy,34925,11490,23435,MÉLENCHON Jean-Luc,22
93030,Dugny,5483,1642,3841,MÉLENCHON Jean-Luc,22
93031,Epinay-sur-Seine,26080,9247,16833,MÉLENCHON Jean-Luc,22
93032,Gagny,21870,5816,16054,MÉLENCHON Jean-Luc,22
93033,Gournay-sur-Marne,4742,1026,3716,MACRON Emmanuel,22
93039,L'Ile-Saint-Denis,3974,1056,2918,MÉLENCHON Jean-Luc,22
93045,Les Lilas,14583,3340,11243,MÉLENCHON Jean-Luc,22
93046,Livry-Gargan,22252,6046,16206,MÉLENCHON Jean-Luc,22
93047,Montfermeil,13482,4139,9343,MÉLENCHON Jean-Luc,22
93048,Montreuil,60784,15686,45098,MÉLENCHON Jean-Luc,22
93049,Neuilly-Plaisance,12648,3070,9578,MACRON Emmanuel,22
93050,Neuilly-sur-Marne,19355,5427,13928,MÉLENCHON Jean-Luc,22
93051,Noisy-le-Grand,38303,9370,28933,MÉLENCHON Jean-Luc,22
93053,Noisy-le-Sec,20319,6152,14167,MÉLENCHON Jean-Luc,22
93055,Pantin,26962,6848,20114,MÉLENCHON Jean-Luc,22
93057,Les Pavillons-sous-Bois,11695,3615,8080,MÉLENCHON Jean-Luc,22
93059,Pierrefitte-sur-Seine,10985,3360,7625,MÉLENCHON Jean-Luc,22
93061,Le Pré-Saint-Gervais,9422,2205,7217,MÉLENCHON Jean-Luc,22
93062,Le Raincy,10094,2618,7476,MACRON Emmanuel,22
93063,Romainville,16451,4939,11512,MÉLENCHON Jean-Luc,22
93064,Rosny-sous-Bois,23709,7369,16340,MÉLENCHON Jean-Luc,22
93066,Saint-Denis,47382,16057,31325,MÉLENCHON Jean-Luc,22
93070,Saint-Ouen-sur-Seine,26748,7051,19697,MÉLENCHON Jean-Luc,22
93071,Sevran,22838,7365,15473,MÉLENCHON Jean-Luc,22
93072,Stains,17196,6716,10480,MÉLENCHON Jean-Luc,22
93073,Tremblay-en-France,20746,6421,14325,MÉLENCHON Jean-Luc,22
93074,Vaujours,3953,1183,2770,MÉLENCHON Jean-Luc,22
93077,Villemomble,15573,3549,12024,MÉLENCHON Jean-Luc,22
93078,Villepinte,19394,6308,13086,MÉLENCHON Jean-Luc,22
93079,Villetaneuse,6003,1995,4008,MÉLENCHON Jean-Luc,22
94001,Ablon-sur-Seine,3121,708,2413,MÉLENCHON Jean-Luc,22
94002,Alfortville,23940,5388,18552,MÉLENCHON Jean-Luc,22
94003,Arcueil,12682,3441,9241,MÉLENCHON Jean-Luc,22
94004,Boissy-Saint-Léger,8869,2520,6349,MÉLENCHON Jean-Luc,22
94011,Bonneuil-sur-Marne,9414,2887,6527,MÉLENCHON Jean-Luc,22
94015,Bry-sur-Marne,11224,2253,8971,MACRON Emmanuel,22
94016,Cachan,17026,3924,13102,MÉLENCHON Jean-Luc,22
94017,Champigny-sur-Marne,42977,12818,30159,MÉLENCHON Jean-Luc,22
94018,Charenton-le-Pont,19864,4043,15821,MACRON Emmanuel,22
94019,Chennevières-sur-Marne,10715,2747,7968,MACRON Emmanuel,22
94021,Chevilly-Larue,10876,3141,7735,MÉLENCHON Jean-Luc,22
94022,Choisy-le-Roi,20592,4879,15713,MÉLENCHON Jean-Luc,22
94028,Créteil,46556,12428,34128,MÉLENCHON Jean-Luc,22
94033,Fontenay-sous-Bois,33361,8261,25100,MÉLENCHON Jean-Luc,22
94034,Fresnes,14916,4362,10554,MÉLENCHON Jean-Luc,22
94037,Gentilly,9968,2379,7589,MÉLENCHON Jean-Luc,22
94038,L'Hay-les-Roses,18648,4734,13914,MÉLENCHON Jean-Luc,22
94041,Ivry-sur-Seine,29966,7011,22955,MÉLENCHON Jean-Luc,22
94042,Joinville-le-Pont,12967,2684,10283,MACRON Emmanuel,22
94043,Le Kremlin-Bicêtre,14414,4078,10336,MÉLENCHON Jean-Luc,22
94044,Limeil-Brévannes,12944,3222,9722,MÉLENCHON Jean-Luc,22
94046,Maisons-Alfort,36908,8156,28752,MACRON Emmanuel,22
94047,Mandres-les-Roses,3167,674,2493,MACRON Emmanuel,22
94048,Marolles-en-Brie,3654,697,2957,MACRON Emmanuel,22
94052,Nogent-sur-Marne,22307,4835,17472,MACRON Emmanuel,22
94053,Noiseau,3366,731,2635,MACRON Emmanuel,22
94054,Orly,11793,3469,8324,MÉLENCHON Jean-Luc,22
94055,Ormesson-sur-Marne,6806,1497,5309,MACRON Emmanuel,22
94056,Périgny-sur-Yerres,1782,376,1406,MACRON Emmanuel,22
94058,Le Perreux-sur-Marne,23853,5448,18405,MACRON Emmanuel,22
94059,Le Plessis-Trévise,11530,2677,8853,MACRON Emmanuel,22
94060,La Queue-en-Brie,7044,1755,5289,MÉLENCHON Jean-Luc,22
94065,Rungis,4133,844,3289,MACRON Emmanuel,22
94067,Saint-Mandé,15617,3459,12158,MACRON Emmanuel,22
94068,Saint-Maur-des-Fossés,50466,9713,40753,MACRON Emmanuel,22
94069,Saint-Maurice,8250,1828,6422,MACRON Emmanuel,22
94070,Santeny,2791,551,2240,MACRON Emmanuel,22
94071,Sucy-en-Brie,17112,3467,13645,MACRON Emmanuel,22
94073,Thiais,17376,4386,12990,MÉLENCHON Jean-Luc,22
94074,Valenton,6792,2217,4575,MÉLENCHON Jean-Luc,22
94075,Villecresnes,7305,1577,5728,MACRON Emmanuel,22
94076,Villejuif,30738,8648,22090,MÉLENCHON Jean-Luc,22
94077,Villeneuve-le-Roi,11218,3248,7970,MÉLENCHON Jean-Luc,22
94078,Villeneuve-Saint-Georges,11557,3362,8195,MÉLENCHON Jean-Luc,22
94079,Villiers-sur-Marne,16861,4023,12838,MÉLENCHON Jean-Luc,22
94080,Vincennes,32777,5704,27073,MACRON Emmanuel,22
94081,Vitry-sur-Seine,45843,14159,31684,MÉLENCHON Jean-Luc,22
95002,Ableiges,706,100,606,MACRON Emmanuel,22
95008,Aincourt,560,85,475,LE PEN Marine,22
95011,Ambleville,305,58,247,LE PEN Marine,22
95012,Amenucourt,154,36,118,LE PEN Marine,22
95014,Andilly,1506,293,1213,MACRON Emmanuel,22
95018,Argenteuil,52609,15665,36944,MÉLENCHON Jean-Luc,22
95019,Arnouville,7765,2385,5380,MÉLENCHON Jean-Luc,22
95023,Arronville,464,66,398,MACRON Emmanuel,22
95024,Arthies,192,37,155,MACRON Emmanuel,22
95026,Asnières-sur-Oise,2174,419,1755,LE PEN Marine,22
95028,Attainville,1199,247,952,LE PEN Marine,22
95039,Auvers-sur-Oise,5208,979,4229,MACRON Emmanuel,22
95040,Avernes,663,115,548,MACRON Emmanuel,22
95042,Baillet-en-France,1531,357,1174,MACRON Emmanuel,22
95046,Banthelu,104,16,88,LE PEN Marine,22
95051,Beauchamp,6136,1289,4847,MACRON Emmanuel,22
95052,Beaumont-sur-Oise,5596,1599,3997,MÉLENCHON Jean-Luc,22
95054,Le Bellay-en-Vexin,163,19,144,LE PEN Marine,22
95055,Bellefontaine,288,73,215,LE PEN Marine,22
95056,Belloy-en-France,1372,297,1075,LE PEN Marine,22
95058,Bernes-sur-Oise,1655,357,1298,MÉLENCHON Jean-Luc,22
95059,Berville,275,63,212,MACRON Emmanuel,22
95060,Bessancourt,5164,1246,3918,MACRON Emmanuel,22
95061,Béthemont-la-Forêt,336,62,274,MACRON Emmanuel,22
95063,Bezons,16028,4601,11427,MÉLENCHON Jean-Luc,22
95074,Boisemont,617,101,516,MACRON Emmanuel,22
95078,Boissy-l'Aillerie,1373,262,1111,MACRON Emmanuel,22
95088,Bonneuil-en-France,551,131,420,MÉLENCHON Jean-Luc,22
95091,Bouffémont,4089,1002,3087,MÉLENCHON Jean-Luc,22
95094,Bouqueval,195,46,149,LE PEN Marine,22
95101,Bray-et-Lû,601,115,486,LE PEN Marine,22
95102,Bréançon,329,61,268,MACRON Emmanuel,22
95110,Brignancourt,194,24,170,MACRON Emmanuel,22
95116,Bruyères-sur-Oise,2791,717,2074,MÉLENCHON Jean-Luc,22
95119,Buhy,228,57,171,MACRON Emmanuel,22
95120,Butry-sur-Oise,1656,348,1308,LE PEN Marine,22
95127,Cergy,32343,9722,22621,MÉLENCHON Jean-Luc,22
95134,Champagne-sur-Oise,3650,973,2677,MACRON Emmanuel,22
95139,La Chapelle-en-Vexin,221,50,171,LE PEN Marine,22
95141,Charmont,24,0,24,MACRON Emmanuel,22
95142,Chars,1205,212,993,LE PEN Marine,22
95144,Châtenay-en-France,53,9,44,MACRON Emmanuel,22
95149,Chaumontel,2592,582,2010,LE PEN Marine,22
95150,Chaussy,481,80,401,MACRON Emmanuel,22
95151,Chauvry,220,39,181,MACRON Emmanuel,22
95154,Chennevières-lès-Louvres,195,24,171,LE PEN Marine,22
95157,Chérence,152,15,137,MACRON Emmanuel,22
95166,Cléry-en-Vexin,332,63,269,MACRON Emmanuel,22
95169,Commeny,352,56,296,MACRON Emmanuel,22
95170,Condécourt,382,56,326,LE PEN Marine,22
95176,Cormeilles-en-Parisis,16830,3876,12954,MACRON Emmanuel,22
95177,Cormeilles-en-Vexin,874,176,698,LE PEN Marine,22
95181,Courcelles-sur-Viosne,229,42,187,MACRON Emmanuel,22
95183,Courdimanche,4449,1011,3438,MACRON Emmanuel,22
95197,Deuil-la-Barre,14438,3805,10633,MÉLENCHON Jean-Luc,22
95199,Domont,10018,2430,7588,MACRON Emmanuel,22
95203,Eaubonne,15838,3579,12259,MACRON Emmanuel,22
95205,Ecouen,4770,1280,3490,MÉLENCHON Jean-Luc,22
95210,Enghien-les-Bains,7940,1805,6135,MACRON Emmanuel,22
95211,Ennery,1554,268,1286,MACRON Emmanuel,22
95212,Epiais-lès-Louvres,89,13,76,LE PEN Marine,22
95213,Epiais-Rhus,544,89,455,MACRON Emmanuel,22
95214,Epinay-Champlâtreux,37,8,29,ZEMMOUR Éric,22
95218,Eragny,11231,3080,8151,MÉLENCHON Jean-Luc,22
95219,Ermont,18466,4689,13777,MÉLENCHON Jean-Luc,22
95229,Ezanville,6107,1557,4550,MÉLENCHON Jean-Luc,22
95241,Fontenay-en-Parisis,1220,232,988,LE PEN Marine,22
95250,Fosses,6300,1650,4650,MÉLENCHON Jean-Luc,22
95252,Franconville,21801,5912,15889,MÉLENCHON Jean-Luc,22
95253,Frémainville,374,83,291,MACRON Emmanuel,22
95254,Frémécourt,423,79,344,LE PEN Marine,22
95256,Frépillon,2153,446,1707,MACRON Emmanuel,22
95257,La Frette-sur-Seine,3098,612,2486,MACRON Emmanuel,22
95258,Frouville,318,62,256,MACRON Emmanuel,22
95268,Garges-lès-Gonesse,18245,6542,11703,MÉLENCHON Jean-Luc,22
95270,Genainville,422,73,349,LE PEN Marine,22
95271,Génicourt,374,49,325,MACRON Emmanuel,22
95277,Gonesse,14619,4755,9864,MÉLENCHON Jean-Luc,22
95280,Goussainville,16168,5454,10714,MÉLENCHON Jean-Luc,22
95282,Gouzangrez,125,10,115,MACRON Emmanuel,22
95287,Grisy-les-Plâtres,543,101,442,MACRON Emmanuel,22
95288,Groslay,5231,1282,3949,MÉLENCHON Jean-Luc,22
95295,Guiry-en-Vexin,142,21,121,MACRON Emmanuel,22
95298,Haravilliers,452,80,372,MACRON Emmanuel,22
95301,Haute-Isle,206,44,162,MACRON Emmanuel,22
95303,Le Heaulme,161,20,141,MACRON Emmanuel,22
95304,Hédouville,218,26,192,MACRON Emmanuel,22
95306,Herblay-sur-Seine,19670,4722,14948,MACRON Emmanuel,22
95308,Hérouville,456,61,395,MACRON Emmanuel,22
95309,Hodent,157,26,131,MACRON Emmanuel,22
95313,L'Isle-Adam,8752,1758,6994,MACRON Emmanuel,22
95316,Jagny-sous-Bois,220,42,178,LE PEN Marine,22
95323,Jouy-le-Moutier,11057,2639,8418,MÉLENCHON Jean-Luc,22
95328,Labbeville,422,72,350,MACRON Emmanuel,22
95331,Lassy,120,19,101,LE PEN Marine,22
95341,Livilliers,279,54,225,MACRON Emmanuel,22
95348,Longuesse,423,79,344,MACRON Emmanuel,22
95351,Louvres,6482,1923,4559,MÉLENCHON Jean-Luc,22
95352,Luzarches,3409,700,2709,MACRON Emmanuel,22
95353,Maffliers,1219,237,982,LE PEN Marine,22
95355,Magny-en-Vexin,3661,859,2802,LE PEN Marine,22
95365,Mareil-en-France,458,102,356,LE PEN Marine,22
95369,Margency,2003,353,1650,MACRON Emmanuel,22
95370,Marines,2431,626,1805,LE PEN Marine,22
95371,Marly-la-Ville,4027,1006,3021,LE PEN Marine,22
95379,Maudétour-en-Vexin,171,27,144,MACRON Emmanuel,22
95387,Menouville,45,7,38,LE PEN Marine,22
95388,Menucourt,3883,759,3124,MACRON Emmanuel,22
95392,Mériel,3649,801,2848,MACRON Emmanuel,22
95394,Méry-sur-Oise,6445,1504,4941,MACRON Emmanuel,22
95395,Le Mesnil-Aubry,634,103,531,LE PEN Marine,22
95409,Moisselles,852,171,681,MACRON Emmanuel,22
95422,Montgeroult,298,45,253,MACRON Emmanuel,22
95424,Montigny-lès-Cormeilles,11949,3457,8492,MÉLENCHON Jean-Luc,22
95426,Montlignon,2211,441,1770,MACRON Emmanuel,22
95427,Montmagny,7537,2105,5432,MÉLENCHON Jean-Luc,22
95428,Montmorency,13529,2956,10573,MACRON Emmanuel,22
95429,Montreuil-sur-Epte,329,71,258,MACRON Emmanuel,22
95430,Montsoult,2635,566,2069,MACRON Emmanuel,22
95436,Mours,1124,228,896,MACRON Emmanuel,22
95438,Moussy,97,17,80,LE PEN Marine,22
95445,Nerville-la-Forêt,458,82,376,MACRON Emmanuel,22
95446,Nesles-la-Vallée,1512,299,1213,MACRON Emmanuel,22
95447,Neuilly-en-Vexin,147,23,124,MACRON Emmanuel,22
95450,Neuville-sur-Oise,1189,164,1025,MACRON Emmanuel,22
95452,Nointel,604,90,514,MACRON Emmanuel,22
95456,Noisy-sur-Oise,439,93,346,MACRON Emmanuel,22
95459,Nucourt,575,92,483,LE PEN Marine,22
95462,Omerville,271,48,223,LE PEN Marine,22
95476,Osny,10896,2844,8052,MACRON Emmanuel,22
95480,Parmain,4296,978,3318,MACRON Emmanuel,22
95483,Le Perchay,415,89,326,MACRON Emmanuel,22
95487,Persan,6118,1853,4265,MÉLENCHON Jean-Luc,22
95488,Pierrelaye,5387,1573,3814,MÉLENCHON Jean-Luc,22
95489,Piscop,466,70,396,MACRON Emmanuel,22
95491,Le Plessis-Bouchard,5709,1196,4513,MACRON Emmanuel,22
95492,Le Plessis-Gassot,61,3,58,LE PEN Marine,22
95493,Le Plessis-Luzarches,100,11,89,MACRON Emmanuel,22
95500,Pontoise,17001,4603,12398,MÉLENCHON Jean-Luc,22
95504,Presles,2703,533,2170,MACRON Emmanuel,22
95509,Puiseux-en-France,2529,682,1847,MÉLENCHON Jean-Luc,22
95510,Puiseux-Pontoise,381,84,297,MACRON Emmanuel,22
95523,La Roche-Guyon,307,72,235,MACRON Emmanuel,22
95527,Roissy-en-France,1537,422,1115,LE PEN Marine,22
95529,Ronquerolles,649,122,527,MACRON Emmanuel,22
95535,Sagy,924,207,717,LE PEN Marine,22
95539,Saint-Brice-sous-Forêt,8857,2413,6444,MACRON Emmanuel,22
95541,Saint-Clair-sur-Epte,618,170,448,LE PEN Marine,22
95543,Saint-Cyr-en-Arthies,173,33,140,MACRON Emmanuel,22
95554,Saint-Gervais,701,112,589,MACRON Emmanuel,22
95555,Saint-Gratien,13323,3717,9606,MÉLENCHON Jean-Luc,22
95563,Saint-Leu-la-Forêt,11330,2536,8794,MACRON Emmanuel,22
95566,Saint-Martin-du-Tertre,1822,500,1322,LE PEN Marine,22
95572,Saint-Ouen-l'Aumône,13025,3680,9345,MÉLENCHON Jean-Luc,22
95574,Saint-Prix,5565,1258,4307,MACRON Emmanuel,22
95580,Saint-Witz,1939,396,1543,MACRON Emmanuel,22
95582,Sannois,16529,4229,12300,MÉLENCHON Jean-Luc,22
95584,Santeuil,497,66,431,MACRON Emmanuel,22
95585,Sarcelles,28284,10076,18208,MÉLENCHON Jean-Luc,22
95592,Seraincourt,985,209,776,MACRON Emmanuel,22
95594,Seugy,769,138,631,MACRON Emmanuel,22
95598,Soisy-sous-Montmorency,11728,3287,8441,MACRON Emmanuel,22
95604,Survilliers,2388,558,1830,LE PEN Marine,22
95607,Taverny,17313,3981,13332,MÉLENCHON Jean-Luc,22
95610,Théméricourt,232,44,188,MACRON Emmanuel,22
95611,Theuville,27,3,24,ZEMMOUR Éric,22
95612,Le Thillay,2430,693,1737,MÉLENCHON Jean-Luc,22
95625,Us,958,183,775,MACRON Emmanuel,22
95627,Vallangoujard,447,63,384,MACRON Emmanuel,22
95628,Valmondois,966,185,781,MACRON Emmanuel,22
95633,Vaudherland,59,16,43,LE PEN Marine,22
95637,Vauréal,11521,2959,8562,MÉLENCHON Jean-Luc,22
95641,Vémars,1782,485,1297,LE PEN Marine,22
95651,Vétheuil,608,103,505,MÉLENCHON Jean-Luc,22
95652,Viarmes,4021,908,3113,LE PEN Marine,22
95656,Vienne-en-Arthies,332,56,276,MACRON Emmanuel,22
95658,Vigny,885,169,716,MACRON Emmanuel,22
95660,Villaines-sous-Bois,536,77,459,LE PEN Marine,22
95675,Villeron,796,134,662,LE PEN Marine,22
95676,Villers-en-Arthies,390,50,340,MACRON Emmanuel,22
95678,Villiers-Adam,603,72,531,MACRON Emmanuel,22
95680,Villiers-le-Bel,12401,4013,8388,MÉLENCHON Jean-Luc,22
95682,Villiers-le-Sec,110,14,96,MACRON Emmanuel,22
95690,Wy-dit-Joli-Village,285,48,237,MACRON Emmanuel,22
